*************
000000X000000
0XX00VXV00XX0
0#X0XXXXX0X#0
0000000000000
00X00XXX00X00
00#000X000#00
00#0000000#00
00X0000000X00
0000000000000
000X##X##X000
0#000X0X000#0
X##0000000##X
#X00P0B0000X#
20