*************
##V00###00V##
#X0X#000#X0X#
X000X000X000X
0000000000000
00XXX###XXX00
0X000X#X000X0
0000000000000
#00000000000#
X#0XX000XX0#X
X#000000000#X
#000XXXXX000#
000X00000X000
0000P0B000000
22