*************
V#00VXXXV00#V
#000XXXXX000#
0000X#X#X0000
0000XXXXX0000
#0000X0X0000#
#000X0X0X000#
#0000XXX0000#
00X0000000X00
000000X000000
000X00000X000
00000X0X00000
00X0000000X00
X000P0B00000X
24