*************
VXV0000000VXV
0X0000X0000X0
0X0X00X00X0X0
000000X000000
XX0X00X00X0XX
000000X000000
0000000000000
0000000000000
000000X000000
0000000000000
00X0000000X00
0000000000000
X00XP0B00X00X
