*************
00000XX0XX000
00000XX0XX000
0000000000000
00000XX0XX000
00000XX0XX000
0000000000000
0000000000000
0000000000000
0000000000000
0000000000000
0000000000000
0000000000000
P00000B000000
