*************
VXV0000000VXV
0X0000X0000X0
0X0X00X00X0X0
00#000X000#00
XX0X00X00X0XX
#00000X00000#
0000000000000
0000000000000
00000XXX00000
0000000000000
00X0000000X00
0000000000000
X##XP0B00X##X
12