*************
V0000X00XV0X#
XXX00#00XX00X
00X0XX0XX0000
00X0X00000000
0000000000X#0
0#000###00000
0#00X#X#X0000
00000###00000
000X000000000
000000X000000
0X0000000#0X0
#XX0000000XX#
##00P0B0000##
16