*************
##V00###00V##
#X0X#000#X0X#
X000X000X000X
0000000000000
0000000000000
0000000000000
0000000000000
0000000000000
0000000000000
0000000000000
0000XXXXX0000
000X00000X000
0000P0B000000
22